creaPrograma: DecTipos x DecVariables x DecSubprogramas x Bloque -> Programa

creaBool: Tipo
creaInt: Tipo
creaDouble: Tipo
creaId: String -> Tipo
creaArray: Integer x Tipo -> Tipo
creaStruct: List (String x Tipo) -> Tipo
creaPuntero: Tipo -> Tipo

creaDecTipos: DecTipos x String x Tipo -> DecTipos
creaDecVariables: DecVariables x String x Tipo -> DecVariables
creaDecSubprogramas: DecSubprogramas x String x List(Parametro) x Programa -> DecSubprogramas

creaParametro: Boolean (modo) x String (identificador) x Tipo -> Parametro

creaAsignacion: Designador x Expresion -> Instruccion
creaBloque: List(Instruccion) -> Instruccion
creaCondicional: Casos -> Instruccion
creaCasos: Casos x Expresion x Bloque -> 

creaBucle: Casos -> Instruccion
creaLlamada: String (identificador) x List(String) -> Instruccion
creaRead: Designador -> Instruccion
creaWrite: Expresion -> Instruccion
creaNew: Designador -> Instruccion
creaDelete: Designador -> Instruccion

creaDesignador: String (identificador) -> Designador
creaDesignador: Designador x Expresion -> Designador
creaDesignador: Designador x String (identificador) -> Designador

creaExpresionBinaria: Expresion x OpBinario x Expresion -> Expresion
creaExpresionUnaria: OpUnario Expresion -> Expresion
creaExpresionBoolean: Boolean -> Expresion
creaExpresionInteger: Integer -> Expresion
creaExpresionDouble: Double -> Expresion
creaExpresionDesignador: Designador -> Expresion

creaOpBinario: String (tipo) -> OpBinario
creaOpUnario: String (tipo) -> OpUnario







